15 10
0 93
. . . . . . . . . . . . . . .
~ ~ X . . . X X X . . . m m .
. ~ X ~ . . X . . . . . . . .
. . X . . . . ~ X ~ . ~ . . .
. m m m . . . . . . . ~ . . .
. . . . X X m ~ X ~ . ~ . . .
~ ~ X . . . . . . . . X . X .
. ~ X ~ . . . . X . . X . X .
. . X m m m . X X ~ . m m m .
. m m m . . . . . . . . . . .
